Айсберг = Вода + Лед + Гора
Аквариум = Рыба + Вода + Стекло
Акула = Зуб + Рыба
Акула-молот = Молоток + Рыба
Алмаз = Давление + Уголь
Алюминий = Металл + Самолет
Ангел = Человек + Птица
Антенна = Палка + Металл + Радио
Арбалет = Металл + Лук
Арфа = Лук + Струна
Астероид = Космос + Камень
Атом = Электрон + Протон + Нейтрон
Бабочка = Гусеница + Время
Бактерия = Океан + Жизнь
Баобаб = Саванна + Дерево
Банк = Дом + Деньги
Барабан = Бочка + Кожа
Батарейка = Металл + Электричество + Энергия
Башня = Дом + Дом
Бегемот = Корова + Река
Белка = Мышь + Желудь
Бензин = Нефть + Пар
Бетон = Вода + Песок
Библиотека = Дом + Книга
Бинокль = Телескоп + Телескоп
Бинт = Ткань + Лента
Биткойн = Монета + Электричество
Бобр = Зуб + Дерево
Богомол = Насекомое + Лист
Болото = Озеро + Трава
Бочка = Доска + Круг + Металл
Броня = Металл + Одежда
Букет = Цветок + Цветок
Бумага = Древесина + Инструмент
Бутылка = Вода + Пластик
Вазелин = Парафин + Масло
Вакуум = Космос + Стекло
Вампир = Кровь + Человек
Вантуз = Резина + Палка + Вакуум
Ведро = Вода + Пластик + Металл
Ведьма = Метла + Человек + Волшебная палочка
Веер = Бумага + Ветер
Верблюд = Пустыня + Лошадь
Веревка = Нить + Нить + Нить
Весло = Палка + Вода
Ветер = Воздух + Воздух
Взрыв = Огонь + Порох
Вилка = Стейк + Вилы
Вилы = Инструмент + Сено
Вино = Вода + Виноград
Виноград = Палка + Растение + Солнце
Водопад = Вода + Гора
Водород = Солнце + Время
Водоросли = Вода + Растение
Воздушный змей = Веревка + Ткань + Воздух
Воздушный шар = Резина + Воздух + Веревка
Волк = Жизнь + Лес
Волна = Океан + Энергия
Волос = Воск + Человек
Волшебная палочка = Звезда + Палка
Ворона = Птица + Пугало
Воск = Пчела + Пчела
Время = Песок + Стекло
Вулкан = Гора + Лава
Газировка = Вода + Воздух + Сахар
Гамак = Кровать + Сеть
Гвоздь = Палка + Молоток + Металл
Гепард = Саванна + Кошка + Ветер
Гиена = Саванна + Собака
Гирлянда = Лампочка + Лампочка + Лампочка
Гиря = Металл + Гравитация
Гитара = Древесина + Струна + Струна
Глаз = Линза + Жизнь
Глина = Река + Лопата
Гнездо = Яйцо + Птица + Дерево
Голем = Камень + Жизнь
Голубь = Птица + Хлеб
Гора = Земля + Камень
Горизонт = Земля + Небо
Госпиталь = Дом + Здоровье
Грабли = Расческа + Палка
Гравитация = Земля + Земля + Земля
Град = Лед + Облако
Градусник = Ртуть + Жара
Грампластинка = Воск + Пластик
Гриб = Дождь + Трава
Грязь = Вода + Пепел
Гусеница = Червь + Растение
Давление = Воздух + Жара
Дверь = Стена + Доска
Двигатель = Пар + Металл
Дворец = Дом + Король
Деньги = Золото + Бумага
Дерево = Растение + Растение
Джунгли = Лес + Дождь
Динамит = Порох + Веревка
Динозавр = Жизнь + Ископаемое
Дирижабль = Металл + Веревка + Воздушный шар
Дисплей = Стекло + Электричество
Дождевик = Одежда + Дождь
Дождь = Вода + Облако
Доктор = Лекарство + Человек
Дом = Древесина + Стекло + Бетон
Дорога = Земля + Бетон
Доска = Древесина + Древесина + Инструмент
Драгоценный камень = Кирка + Гора
Дракон = Ящерица + Огонь
Древесина = Человек + Лес
Дрожжи = Бактерия + Хлеб
Дятел = Древесина + Птица
Единорог = Волшебная палочка + Лошадь
Ель = Игла + Дерево
Ёж = Мышь + Игла
Жара = Воздух + Огонь
Жвачка = Смола + Зуб
Железная дорога = Металл + Дорога
Желудь = Дерево + Время
Жемчужина = Вода + Драгоценный камень
Жизнь = Энергия + Вода
Жир = Свинья + Лезвие
Жук = Насекомое + Дерево
Замок = Стена + Башня
Замок = Шестеренка + Сундук
Затмение = Солнце + Луна
Звезда = Телескоп + Небо
Звук = Взрыв + Воздух
Здоровье = Человек + Яблоко
Зебра = Саванна + Лошадь
Зелье лечения = Колба + Жизнь
Зелье маны = Звезда + Колба
Зелье мудрости = Колба + Сова
Зелье силы = Гора + Колба
Зелье скорости = Ветер + Колба
Зеркало = Стекло + Свет + Вода
Змея = Клыки + Червь
Золото = Металл + Драгоценный камень
Зомби = Жизнь + Смерть
Зонтик = Ткань + Дождь
Зуб = Кость + Давление
Зубная паста = Зуб + Здоровье
Зубная щетка = Зуб + Инструмент
Зубочистка = Зуб + Палка
Игла = Нить + Металл
Известняк = Камень + Река
Икра = Рыба + Рыба
Инопланетянин = Космос + Жизнь
Инструмент = Человек + Древесина + Металл
Ископаемое = Земля + Лопата + Кисть
Искра = Камень + Камень
Йогурт = Молоко + Бактерия
Йод = Водоросли + Серная кислота
Кабан = Свинья + Лес
Какао = Солнце + Дерево
Кактус = Игла + Растение
Календарь = Бумага + Время
Кальян = Колба + Табак + Пар
Камень = Земля + Земля
Камуфляж = Ткань + Хамелеон
Капля = Пыль + Вода
Карамель = Сахар + Огонь
Карандаш = Древесина + Уголь
Карта = Бумага + Компас
Картина = Бумага + Краски + Кисть
Картон = Бумага + Бумага
Касатка = Кит + Лед
Кентавр = Человек + Лошадь
Керамика = Глина + Жара
Кирка = Инструмент + Гора
Кирпич = Огонь + Глина
Кислород = Растение + Солнце
Кисть = Инструмент + Бумага
Кит = Рыба + Фонтан
Клей = Мука + Вода + Жара
Клоун = Праздник + Человек
Клыки = Зуб + Лезвие
Ключ = Замок + Инструмент
Книга = Чернила + Бумага + Картон
Коготь = Кость + Лезвие
Кожа = Молоток + Свинья
Колба = Вода + Стекло
Колесо = Резина + Воздух + Давление
Колибри = Цветок + Птица
Колодец = Ведро + Лопата + Земля
Кольцо = Металл + Круг
Комар = Кровь + Насекомое
Комбайн = Поле + Двигатель
Компас = Электричество + Магнит
Компьютер = Микрочип + Микрочип
Конура = Дом + Собака
Конфета = Бумага + Шоколад
Коньки = Лед + Обувь + Лезвие
Копилка = Деньги + Свинья
Копье = Лезвие + Палка + Палка
Корабль = Ткань + Вода + Древесина
Корень = Растение + Земля + Вода
Коробка = Картон + Картон
Корова = Луг + Жизнь
Король = Корона + Человек
Корона = Золото + Драгоценный камень
Косметика = Человек + Краски
Космос = Звезда + Небо
Костер = Палка + Палка + Огонь
Кость = Нож + Зомби
Кофе = Вода + Жара + Какао
Кошелек = Деньги + Кожа
Кошка = Человек + Тигр
Краб = Ножницы + Рыба
Краски = Доска + Радуга
Кредитка = Деньги + Пластик
Кремний = Давление + Песок
Кровать = Древесина + Подушка
Кровь = Лезвие + Человек
Крокодил = Болото + Ящерица
Крот = Мышь + Земля
Круг = Циркуль + Бумага
Кузнечик = Насекомое + Трава
Кукла = Человек + Шерсть
Курица = Пшеница + Птица
Лава = Огонь + Земля
Лазер = Свет + Огонь
Ламантин = Корова + Вода
Лампочка = Стекло + Электричество + Свет
Лев = Саванна + Кошка
Лед = Вода + Мороз
Леденец = Палка + Конфета
Лезвие = Инструмент + Металл
Лекарство = Бактерия + Здоровье
Лента = Ножницы + Ткань
Лес = Дерево + Дерево
Летучая мышь = Кровь + Воздух
Линейка = Доска + Карандаш
Линза = Стекло + Свет
Лист = Ветер + Дерево
Лишайник = Гриб + Водоросли
Лодка = Весло + Плот
Лопата = Инструмент + Земля
Лошадь = Жизнь + Сено
Луг = Земля + Трава
Лужа = Вода + Дорога
Лук = Веревка + Палка
Луна = Камень + Небо
Любовь = Человек + Человек
Лягушка = Болото + Жизнь
Магнит = Металл + Электричество
Манта = Рыба + Воздушный змей
Марка = Почта + Картина
Маска = Веревка + Ткань
Масло = Жир + Вода
Машина = Колесо + Двигатель
Маяк = Башня + Свет
Мед = Пчела + Цветок
Медведь = Коготь + Пещера
Мел = Карандаш + Известняк
Мельница = Ветер + Камень
Металл = Огонь + Камень
Метан = Воздух + Болото
Метеор = Огонь + Астероид
Метла = Палка + Сено
Метро = Тунель + Земля
Микроскоп = Бактерия + Линза
Микрофон = Звук + Палка
Микрочип = Металл + Кремний
Минотавр = Человек + Корова
Мираж = Жара + Воздух + Пустыня
Мозг = Нейрон + Нейрон + Нейрон
Молекула = Атом + Атом
Молния = Облако + Облако + Облако
Молоко = Ведро + Корова
Молоток = Палка + Камень
Монета = Золото + Круг
Морж = Клыки + Ламантин
Мороженое = Лед + Сахар
Мороз = Воздух + Ветер
Морская звезда = Звезда + Океан
Морской конек = Рыба + Лошадь
Мост = Река + Дорога
Мох = Растение + Камень
Музыка = Грампластинка + Игла
Мука = Пшеница + Мельница
Мул = Лошадь + Осел
Мумия = Человек + Бинт
Муха = Насекомое + Воздух
Мыло = Пепел + Жир
Мышь = Жизнь + Пшеница
Мясо = Лезвие + Корова
Мяч = Резина + Воздух
Наковальня = Молоток + Металл
Насекомое = Червь + Земля
Небо = Воздух + Воздух + Воздух
Нейрон = Электричество + Жизнь
Нейтрон = Электрон + Протон
Нейтронная звезда = Нейтрон + Звезда
Нефть = Земля + Растение + Ископаемое
Нить = Паутина + Паутина
Новогодняя елка = Звезда + Гирлянда + Ель
Нож = Лезвие + Палка
Ножницы = Лезвие + Лезвие
Носорог = Саванна + Рога
Нунчаки = Палка + Палка + Цепь
Оазис = Пустыня + Озеро
Обезьяна = Жизнь + Дерево
Облако = Вода + Воздух
Обои = Стена + Бумага + Клей
Оборотень = Человек + Волк + Луна
Обсидиан = Лава + Вода
Обувь = Земля + Ткань
Овца = Гора + Жизнь
Огнетушитель = Пена + Пожар
Одежда = Игла + Ткань
Озеро = Вода + Вода
Озон = Солнце + Кислород
Океан = Вода + Вода + Вода
Окно = Древесина + Стекло
Олень = Лес + Лошадь
Орел = Птица + Гора
Осел = Лошадь + Овца
Остров = Земля + Океан
Осьминог = Рыба + Вакуум
Охота = Человек + Лук
Очки = Линза + Глаз + Пластик
Палатка = Палка + Ткань + Дом
Палка = Лезвие + Растение
Пальма = Дерево + Пляж
Панда = Медведь + Джунгли
Папоротник = Растение + Споры
Пар = Вода + Огонь
Парафин = Углеводород + Воск
Парик = Волос + Волос
Парус = Ткань + Ветер
Парфюм = Колба + Цветок
Паук = Насекомое + Насекомое
Паутина = Муха + Паук
Пегас = Птица + Лошадь
Пена = Пузырь + Вода
Пенек = Дерево + Топор
Пенициллин = Лекарство + Плесень
Пепел = Вода + Костер
Перо = Ножницы + Птица
Перфокарта = Игла + Бумага
Песок = Вода + Камень
Печенье = Молоко + Какао + Тесто
Печь = Огонь + Камень + Уголь
Пещера = Время + Гора
Пиво = Пшеница + Вода
Пила = Клыки + Инструмент
Пингвин = Птица + Мороз
Пирамида = Гора + Песок
Пирог = Мука + Яблоко
Письмо = Чернила + Бумага
Пиявка = Червь + Кровь
Планета = Земля + Гравитация
Планктон = Бактерия + Краб + Водоросли
Пластик = Нефть + Уголь
Пластилин = Глина + Нефть
Плесень = Гриб + Мох
Плот = Древесина + Вода
Плотина = Бобр + Река
Плуг = Лезвие + Земля
Пляж = Песок + Океан
Подарок = Лента + Коробка
Подзорная труба = Линза + Труба
Подкова = Лошадь + Обувь
Подсолнух = Солнце + Цветок
Подушка = Ткань + Перо
Поезд = Машина + Железная дорога
Пожар = Лес + Огонь
Позвоночник = Кость + Нейрон
Поле = Земля + Плуг
Полярный медведь = Медведь + Снег
Попугай = Птица + Джунгли
Порох = Селитра + Уголь
Почта = Голубь + Письмо
Праздник = Торт + Фейерверк + Воздушный шар
Призрак = Человек + Смерть
Прилив = Океан + Луна
Провод = Металл + Электричество + Пластик
Пропан = Нефть + Огонь
Протон = Электрон + Гравитация
Птица = Жизнь + Воздух
Пугало = Человек + Сено
Пузырь = Мыло + Воздух
Пустыня = Песок + Солнце
Пушка = Порох + Труба
Пчела = Насекомое + Цветок
Пшеница = Земля + Лопата + Вода
Пыль = Грязь + Время
Радио = Звук + Металл
Радуга = Дождь + Солнце
Ракета = Огонь + Труба
Расческа = Волос + Пластик
Растение = Вода + Земля
Ребенок = Человек + Человек + Любовь
Резина = Нефть + Вода
Река = Вода + Вода + Земля
Ржавчина = Кислород + Металл
Робот = Батарейка + Человек
Ров = Замок + Река
Рога = Кость + Кость + Лезвие
Рогатка = Резина + Палка
Роза = Любовь + Цветок
Ртуть = Серебро + Вода
Руда = Кирка + Шахта
Рулетка = Лента + Линейка
Русалка = Человек + Рыба
Ручка = Чернила + Пластик
Рыба = Жизнь + Вода
Рыба-меч = Рыба + Нож
Рыцарь = Человек + Броня + Нож
Рычаг = Шестеренка + Палка
Саванна = Земля + Трава + Солнце
Самокат = Колесо + Колесо
Самолет = Воздух + Металл
Сахар = Сахарный тростник + Мельница
Сахарный тростник = Палка + Растение + Вода
Сачок = Сеть + Палка
Свет = Небо + Солнце
Светлячок = Лампочка + Насекомое
Светофор = Гирлянда + Дорога
Свеча = Огонь + Воск
Свинья = Грязь + Жизнь
Сейф = Замок + Деньги
Секундомер = Время + Линейка
Селитра = Известняк + Растение
Сено = Жара + Трава
Сера = Пепел + Лава
Сердце = Кровь + Двигатель
Серебро = Монета + Печь
Серная кислота = Водород + Кислород + Сера
Серфинг = Доска + Волна
Сеть = Паутина + Вода
Скальпель = Лезвие + Здоровье
Скворечник = Птица + Дом
Скейтборд = Колесо + Доска
Скорпион = Краб + Пустыня
Скотч = Лента + Клей
Скрипка = Древесина + Струна
Скульптура = Человек + Камень
Слеза = Вода + Глаз
Смартфон = Микрофон + Радио
Смерть = Жизнь + Время
Смерч = Ветер + Энергия
Смола = Дерево + Лезвие
Снег = Дождь + Мороз
Снеговик = Человек + Снег
Снежинка = Капля + Мороз
Собака = Человек + Волк
Сова = Птица + Коготь
Созвездие = Звезда + Звезда
Сокровище = Сундук + Остров
Солнечная система = Планета + Солнце
Солнечные панели = Солнце + Энергия
Солнце = Огонь + Небо
Соль = Жара + Океан
Сон = Человек + Кровать
Сосулька = Капля + Лед
Спальник = Кровать + Лес
Спичка = Сера + Палка
Спорт = Человек + Гиря
Споры = Воздух + Мох
Спутник = Антенна + Космос
Стейк = Огонь + Мясо
Стекло = Огонь + Песок
Стена = Кирпич + Бетон
Страус = Птица + Песок
Стрела = Перо + Палка + Лезвие
Струна = Звук + Нить
Сундук = Древесина + Коробка
Суши = Рыба + Водоросли
Сфинкс = Человек + Лев
Сыр = Время + Молоко
Табак = Пар + Растение
Танк = Черепаха + Металл
Телескоп = Линза + Небо
Теплица = Растение + Стекло
Тесто = Мука + Вода
Тигр = Жизнь + Джунгли
Ткань = Нить + Нить
Топор = Лезвие + Палка + Древесина
Торт = Мороженое + Тесто
Торф = Давление + Болото
Трава = Земля + Растение
Троянский конь = Древесина + Лошадь
Труба = Палка + Металл + Воздух
Тряпка = Грязь + Ткань
Туман = Капля + Воздух
Тунель = Гора + Дорога
Уборщик = Метла + Человек
Углеводород = Водород + Углерод
Углекислый газ = Углерод + Кислород
Углерод = Огонь + Уголь
Уголь = Огонь + Растение
Угорь = Червь + Электричество
Удочка = Веревка + Палка + Червь
Улей = Пчела + Дом
Улитка = Гусеница + Клей
Утка = Птица + Озеро
Факел = Палка + Огонь
Фейерверк = Взрыв + Ракета
Феникс = Птица + Огонь
Флаг = Палка + Ткань
Флейта = Ветер + Труба
Фонарик = Батарейка + Свет
Фонарь = Масло + Стекло
Фонтан = Вода + Давление
Фотоаппарат = Бумага + Металл + Свет
Фотосинтез = Солнце + Лист
Хамелеон = Ящерица + Радуга
Хлеб = Огонь + Тесто
Хлопок = Облако + Трава
Холодильник = Мороз + Электричество
Хомяк = Пшеница + Мышь
Цветок = Растение + Жизнь
Цепная пила = Пила + Двигатель
Цепь = Веревка + Металл
Цербер = Собака + Собака + Собака
Цирк = Дом + Клоун
Циркуль = Игла + Карандаш
Чай = Жара + Вода + Растение
Чайка = Птица + Океан
Часы = Батарейка + Время
Человек = Время + Обезьяна
Червь = Жизнь + Земля
Череп = Кость + Мозг
Черепаха = Яйцо + Песок
Черная дыра = Гравитация + Гравитация + Гравитация
Чернила = Осьминог + Давление
Шахта = Кирка + Пещера
Швейная машинка = Игла + Электричество
Шелк = Гусеница + Нить
Шерсть = Ножницы + Овца
Шестеренка = Колесо + Металл
Шоколад = Сахар + Какао
Шприц = Игла + Здоровье
Щит = Доска + Металл
Электричество = Молния + Металл
Электрон = Электричество + Электричество
Энергия = Молния + Молния
Яблоко = Гравитация + Дерево
Яд = Колба + Змея
Яичница = Яйцо + Огонь
Яйцо = Птица + Птица
Якорь = Вода + Металл + Цепь
Яма = Земля + Лопата
Янтарь = Смола + Камень
Ящерица = Трава + Жизнь
GPS = Спутник + Спутник + Спутник